***********************************************************
***********************************************************
***********************************************************
***********************************************************
########..............#.............#...............########
#..........................................................#
#..........................................................#
#.....................#.............#......................#
......................#.............#.......................
......................#.............#.......................
......................#.............#.......................
......................#.............#.......................
......................#.............#.......................
......................#.............#.......................
#....##################......#......###################....#
.............................#..............................
.........................#########..........................
.............................#..............................
#....##################......#......###################....#
......................#.............#.......................
......................#.............#.......................
......................#.............#.......................
......................#.............#.......................
......................#.............#.......................
......................#.............#.......................
#.....................#.............#......................#
#..........................................................#
#..........................................................#
########..............#.............#...............########
