**********************************************************
**********************************************************
**********************************************************
**********************************************************
..........................................................
..........................................................
.......###############..#......#.......#########..........
..............#.........#......#.......#..................
..............#.........#......#.......#..................
..............#.........########.......########...........
..............#.........#......#.......#..................
..............#.........#......#.......#..................
..............#.........#......#.......#########..........
..........................................................
..........................................................
..........................................................
...........#########....#........#....#####...............
...........#............#.#......#....#....#..............
...........#............#..#.....#....#....#..............
...........########.....#....#...#....#....#..............
...........#............#.....#..#....#....#..............
...........#............#......#.#....#....#..............
...........#########....#........#....#####...............
..........................................................
..........................................................

